// Q: 고유 명사
// V: 유형 명사
// U: 무형 명사
// QAA: 포유류         UFl: 감정             UXt: 온도                  VHn: 인간
// QAB: 조류           UGs: 기체             UXw: 무게                  VIv: 세균
// QAC: 어류           UGu: 법죄             UYa: 맛(미각)              VJw: 보석
// QAD: 파충류,양서류  UHr: 음향,소리 상태   UYh: 인간&동물의 외적 형용 VLq: 액체
// QAE: 곤충류         ULm: 억제(제한)       UYi: 인간&동물의 내적 형용 VLt: 모사(모피)
// QAF: 절지동물       ULw: 법제             UYk: 두께                  VLu: 분비물
// QAG: 연체동물       UMe: 시간             UYl: 길이                  VMa: 소재
// QAH: 원생동물       UMn: 수단(방법, 제도) UYm: 냄새(후각)            VMd: 약품
// QAL: 꽃이름(풀이름) UPp: 상&벌            UYp: 가격고저              VMo: 채권(유가증권)
// QAM: 과일명         UQf: 자격             UYq: 면적(넓이)            VMy: 화폐
// QAN: 나무이름       URc: 지각(인지)       UYr: 비율                  VNn: 국가
// QAO: 농작물명       URt: 권리             UYs: 강도                  VPa: 도료
// QCT: 도시(지명)명   USe: 시각(관망)       UYt: 촉감                  VPe: 도구
// QHP: 병원(분야)명   USm: 사상             VAc: 장신구                VPl: 장소
// QID: 산업(업종)명   USo: 노래             VAm: 동물                  VPt: 식물
// QLG: 언어명         USu: 학문             VBk: 책(도서)              VQm: 남성
// QMM: 화폐명         UTh: 생각(사고)       VBl: 건축물                VQw: 여성
// QMS: 언론기관명     UTi: 질병             VBp: 신체부위              VRw: 놀이기구
// QMU: 음악(곡조)명   UTs: 발화(언어수단)   VCk: 주방기기              VRy: 악기
// QNN: 국가명         UTt: 기술             VCm: 통신기기              VSn: 광물
// QNP: 민족명         UXb: 대소(크기, 규모) VCp: 의복                  VSp: 그림
// QPN: 인명           UXd: 거리             VDt: 세제                  VSs: 우주천문관계
// QWK: 작품명         UXe: 난이도           VEl: 전기기구              VSt: 학습도구
// UAq: 직업(신분)     UXf: 양(다소)         VFd: 음식(음료)            VSw: 집필물(기록물)
// UAr: 예술활동       UXg: 위치고저         VFn: 가구                  VTp: 교통수단
// UCl: 종교행위(수단) UXl: 광도(조명)       VFr: 기상관계              VTw: 무기
// UCr: 색상           UXm: 중요도(상세도)   VGn: 신(성인)
// UDr: 방향           UXs: 속도감           VGt: 집합(군집)

呼び方リスト	호칭목록	0
クリキャップ	클리캡	1	VPe
ボールギャグ	볼개그	1	VPe
ニプルキャップ	니플캡	1	VPe
バイブ	바이브	1	VPe
空射精数	드라이사정수	0
手淫経験	수음경험	0
一回休み	한번휴식	0
レズ	레즈	1

// 옷 종류. item.csv 주석.
コスプレセット	코스프레세트	1
//ボンデージ	본디지	1
和服	기모노	1
//メイド服	메이드복	1
チャイナ服	차이나드레스	1
//セーラー服	세라복	1
スク水	학교수영복	1
バニースーツ	바니슈트	1
//体操服	체육복	1
空噴乳	드라이분유	0

// ACT1_愛撫_K21.ERB:769
うりうりうり	으랴으랴으랴	0
うりうり	으랴으랴	0
うりっ	으럇	0
うり	으랴	0

// COM_K40.ERB
なーんちゃって	가짜	0
//、ね

// CSV 명사 고정
腸内射精後経過ターン参照	장내사정후경과턴참조	0
膣内射精後経過ターン参照	질내사정후경과턴참조	0
野外プレイキャンセル補正	야외플레이취소보정	0
媚薬等使用地の文スキップ	미약등사용지문스킵	0
FIRSTTIME用	FIRSTTIME용	0
ダイアログ用一時使用	다이얼로그용일시사용	0
アニメ効果コンフィグ	애니메이션효과콘피그	0
アライメント変動傾向	아라이먼트변동경향	0
パスウェイジョンニードル	파스웨이젼니돌	0
三角木馬キャンセル補正	삼각목마취소보정	0
コスプレキャンセル補正	코스프레취소보정	0
追加行動地の文スキップ	추가행동지문스킵	0
オートモード表示設定	오토모드표시설정	0
苦痛による理性低下	고통에의한이성저하	0
腸内射精後経過ターン	장내사정후경과턴	0
射精後経過ターン参照	사정후경과턴참조	0
膣内射精後経過ターン	질내사정후경과턴	0
調教者連続実行回数	조교자연속실행횟수	0
快楽による理性低下	쾌락에의한이성저하	0
壊れるまでして封印	망가질때까지해봉인	0
コンビネーション予約	콤비네이션예약	0
ソフト方針のヒート	소프트방침히트	0
大満足ボーナス封印	대만족보너스봉인	0
優先大満足ボーナス	우선대만족보너스	0
ノーマル方針のヒート	노멀방침히트	0
イきそう（止め）	갈것같다（그쳐라）	0
今日の満足ボーナス	오늘의만족보너스	0
調教者ペニスバンド	조교자페니스밴드	0
ご奉仕したい封印	봉사함봉인	0
ハード方針のヒート	하드방침히트	0
奉仕対面座位連続	봉사대면좌위연속	0
最長調教時間記録	최장조교시간기록	0
大鏡キャンセル補正	대거울취소보정	0
外に出たい封印	밖에서해봉인	0
公衆肉便器プレイ	공중육변기플레이	0
前回助手愛撫箇所	전회조수애무개소	0
奉仕背面座位連続	봉사배면좌위연속	0
最短調教時間記録	최단조교시간기록	0
前回ターン空射精	전회턴드라이사정	0
アライメント変動	아라이먼트변동	0
休憩方針のヒート	휴식방침히트	0
口で愛撫を強制	입으로애무를강제	0
助手イベント番号	조수이벤트번호	0
童貞喪失済み	동정상실됨	0
同一行動ボーナス	동일행동보너스	0
ペニスバンド装着	페니스밴드장착	0
拘束キャンセル補正	구속취소보정	0
異常方針のヒート	이상방침히트	0
手で愛撫を強制	손으로애무를강제	0
甘えさせて封印	응석부리게해봉인	0
押し倒し経過	쓰러트리기경과	0
処女喪失済み	처녀상실됨	0
奴隷の首輪封印	노예목걸이봉인	0
デバッグ表示オフ	디버그표시오프	0
アナル二穴攻め	애널두구멍공격	0
助手性交奉仕中	조수성교봉사중	0
前回の位置前後	전회의위치전후	0
調教者行動予約	조교자행동예약	0
調教内童貞喪失	조교중동정상실	0
奉仕後背位連続	봉사후배위연속	0
対象消極従回数	대상소극종횟수	0
いつも通り封印	언제나대로봉인	0
奉仕正常位連続	봉사정상위연속	0
前回の位置上下	전회의위치상하	0
対象無影響回数	대상무영향횟수	0
射精後経過ターン	사정후경과턴	0
焦らしプレイ	애태움플레이	0
着衣プレイ好き	착의플레이선호	1
助手性交奉仕中	조수성교봉사중	1
調教内処女喪失	조교중처녀상실	1
前ターン顔面騎乗	전턴안면승마	1
対象積極従回数	대상적극종횟수	1
激しくして封印	격렬하게해봉인	1
もっとハードにして	더하드하게	1
奉仕騎乗位連続	봉사기승위연속	1
オートモード登録	오토모드등록	1
前ターン性交奉仕	전턴성교봉사	1
パラメーター変動	파라미터변동	1
媚薬等使用口上	미약등사용구상	1
対面二穴攻め	대면두구멍공격	1
抜かずの三発	뽑지않고세발	1
かわいがり封印	귀여워해봉인	1
射精量レコード	사정량레코드	1
対象暴れ回数	대상날뛰고횟수	1
前回ターン潮吹き	전회턴분수	1
顔面騎乗アナル	안면승마애널	1
騎乗二穴攻め	승마두구멍공격	1
性奉のヒート	성적봉사히트	1
押し倒し中	쓰러트리기중	1
召喚可能助手	소환가능조수	1
フィストファック	피스트퍽	1
対象哀願回数	대상애원횟수	1
二本舐め強制	2개핥기강제	1
苦痛刻印取得	고통각인취득	1
恐怖刻印取得	공포각인취득	1
両穴フィスト	양구멍피스트	1
性交奉仕回数	성교봉사횟수	1
恥辱快楽経験	치욕쾌락경험	1
お仕置きポイント	벌포인트	1
調教自慰経験	조교자위경험	1
追加行動口上	추가행동구상	1
屈服刻印取得	굴복각인취득	1
調教者行動済	조교자행동제	1
プライド低い	프라이드낮음	1
素質表示方法	소질표시방법	1
背面座位連続	배면좌위연속	1
助手の前行動	조수의전행동	1
助手が挿入中	조수가삽입중	1
前回ターン射精	전회턴사정	1
対象拒否回数	대상거부횟수	1
前回ターン噴乳	전회턴분유	1
調教者消耗度	조교자소모도	1
奉仕快楽経験	봉사쾌락경험	1
自慰見せつけ	자위과시	1
自慰みせつけ	자위과시	1
追加調教者数	추가조교자수	1
前回ターン放尿	전회턴방뇨	1
行動助手番号	행동조수번호	1
苦痛快楽経験	고통쾌락경험	1
調教者とキス	조교자와키스	1
状態変化持続	상태변화지속	1
助手に挿入中	조수에삽입중	1
助手連続交合	조수연속교합	1
今回で大満足	이번에대만족	1
アナルフィスト	애널피스트	1
お仕置きして封印	벌해봉인	1
拠点キャラ数	거점캐릭터수	1
道具使用経験	도구사용경험	1
異常方針回数	이상방침횟수	1
日常能力上昇	일상능력상승	1
性交同時絶頂	성교동시절정	1
快楽刻印取得	쾌락각인취득	1
変則乱れ牡丹	변칙혼란모란	1
口上独自実績	구상독자실적	1
休憩方針回数	휴식방침횟수	1
反発刻印取得	반발각인취득	1
プライド高い	프라이드높음	1
対面座位連続	대면좌위연속	1
アナルセックス	애널섹스	1
胸愛撫強制	가슴애무강제	1
上半身上着	상반신윗도리	1
イベント番号	이벤트번호	1
奴隷の首輪	노예목걸이	1
押し倒し	쓰러트리기	1
加虐のヒート	가학히트	1
目立ちたがり	튀고싶어함	1
器用な指先	기묘한손가락	1
羞恥のヒート	수치히트	1
カスタム道具	커스텀도구	1
使役のヒート	사역히트	1
前回中出し	전회질내사정	1
満足ボーナス	만족보너스	1
要強制勃起	요점강제발기	1
愛撫のヒート	애무히트	1
ペニスバンド	페니스밴드	1
触手使役術	촉수사역술	1
アナルローター	애널로터	1
道具のヒート	도구히트	1
奉仕のヒート	봉사히트	1
アライメント	아라이먼트	1
性交のヒート	성교히트	1
休ませて封印	쉬게해봉인	1
足舐め強制	밟핥기강제	1
お仕置きフラグ	벌플래그	1
異常のヒート	이상히트	1
会話のヒート	회화히트	1
アナルバイブ	애널바이브	1
下半身上着	하반신윗도리	1
地の文スキップ	지문스킵	1
貞操無頓着	정조관념없음	1
前回の姿勢	전회자세	1
放置プレイ	방치플레이	1
焦らし度	애태움수	1
乳首ローター	유두로터	1
快感に素直	쾌감에솔직	1
濡れにくい	젖기어려움	1
助手性交中	조수성교중	1
媚薬等使用	미약등사용	1
快感の否定	쾌감을부정	1
被∨挿入者	피∨삽입자	1
騎乗位連続	기승위연속	1
前立腺射精	전립선사정	1
自慰しやすい	자위쉬움	1
性交奉仕中	성교봉사중	1
必要経験値	필요경험치	1
空射回数	드라이사정수	1
谷渡り	골짜기를건너감	1
淫核／淫茎	음핵／음경	1
経験値アップ	경험치업	1
好感度アップ	호감도업	1
前の勃起度	전발기도	1
既出の話題	기출의화제	1
正常位連続	정상위연속	1
性交奉仕中	성교봉사중	1
アナルビーズ	애널비즈	1
羞恥プレイ	수치플레이	1
触手調教中	촉수조교중	1
前立腺刺激	전립선자극	1
狂気の瞳	광기의눈동자	1
禁断の知識	금단의지식	1
好意的反応	호의적반응	1
前接触指	전접촉손가락	1
下半身下着	하반신속옷	1
ソフト回数	소프트횟수	1
大射回数	대량사정횟수	1
イラマチオ	이라마치오	1
被口内射精	역구강사정	1
前ターン方針	전턴방침	1
オートモード	오토모드	1
上半身下着	상반신속옷	1
方針のヒート	방침히트	0
触手調教中	촉수조교중	1
後背位連続	후배위연속	1
ONCE用	ONCE용	1
八方鬼縛陣	팔방귀박진	1
空射精数	드라이사정수	1
ニプルキャップ	니플캡	1
二つ名	이명[二つ名]	1
被肛内射精	역항내사정	1
前ターン性交	전턴성교	1
性交奉ア調	성교봉아조	1
被膣内射精	역질내사정	1
痛みに強い	아픔에강함	1
助手性交中	조수성교중	1
呼び方リスト	호칭목록	1
野外プレイ	야외플레이	1
ノーマル回数	노멀횟수	1
アイマスク	아이마스크	1
一線越えない	선을그음	1
プレイ時間	플레이시간	1
痛みに弱い	아픔에약함	1
前調教指令	전조교지령	1
地の文制御	지문제어	1
緊急ロード	긴급로드	1
アナル愛撫	애널애무	1
日光嫌い	햇빛싫어함	1
選択セット	선택세트	1
調教レベル	조교레벨	1
スパンキング	스팽킹	1
感情乏しい	감정결핍	1
今回の勃起	이번발기	1
前接触足	전접촉발	1
媚薬ヒート	미약히트	1
子持ち	아이딸린사람	1
胸使用中	가슴사용중	1
ハード回数	하드횟수	1
おもらし癖	소변버릇	1
治療ヒート	치료히트	1
足使用中	발사용중	1
前接触胸	전접촉가슴	1
被写経験	피사계경험	1
濡れやすい	젖기쉬움	1
口で愛撫	입으로애무	1
近寄り難い	대인기피	1
手で愛撫	손으로애무	1
ボールギャグ	볼개그	1
なすがまま	하는대로	1
潮吹き経験	분수경험	1
ロシヒート	로시히트	1
親しみやすい	사교적	0	// 얘는 0이어야 함.
栄養ヒート	영양히트	1
利尿ヒート	이뇨히트	1
浣腸セット	관장세트	1
全身上着	전신윗도리	1
アクセサリ	악세사리	1
鈴蘭の毒	스즈란의독	1
アナル舐め	애널핥기	1
クリキャップ	클리캡	1
日常制御	일상제어	1
接触指	접촉손가락	1
キス経験	키스경험	1
自主脱衣	자주탈의	1
屈服経験	굴복경험	1
薬毒耐性	약물내성	1
反発除去	반발제거	1
羞恥回数	수치횟수	1
肛内射精	항내사정	1
会話回数	회화횟수	1
A絶回数	A절정횟수	1
一回休み	한번휴식	1
手使用中	손사용중	1
前接触口	전접촉입	1
恥薄い	수치심옅음	1
背面座位	배면좌위	1
性交回数	성교횟수	1
異常回数	이상횟수	1
休憩回数	휴식횟수	1
性交経験	성교경험	1
精力絶倫	정력절륜	1
反抗刻印	반항각인	1
積極奉仕	적극봉사	1
触手射精	촉수사정	1
抵抗不能	저항불능	1
射精経験	사정경험	1
トラウマ	트라우마	1
放尿経験	방뇨경험	1
自慰絶頂	자위절정	1
レズ中毒	레즈중독	1
苦痛中毒	고통중독	1
気力管理	기력관리	1
回復遅い	회복느림	1
前接触膣	전접촉질	1
キャラ数	캐릭터수	1
会話経験	회화경험	1
性交ア調	성교아조	1
状態変化	상태변화	1
処女喪失	처녀상실	1
助行パタ	조행파타	1
撮影技能	촬영기술	1
母乳体質	모유체질	1
指挿入	손가락삽입	1
口使用中	입사용중	1
汚臭鈍感	악취둔감	1
対面座位	대면좌위	1
屈服刻印	굴복각인	1
口上予約	구상예약	1
緊縛経験	긴박경험	1
早漏回数	조루횟수	1
絶頂経験	절정경험	1
三角木馬	삼각목마	1
経過時間	경과시간	1
通射回数	사정횟수	1
百合経験	백합경험	1
秘貝開帳	비패개장	1
大量射精	대량사정	1
追加行動	추가행동	1
童貞喪失	동정상실	1
ふたなり	후타나리	1
恐怖経験	공포경험	1
助調方針	조조방침	1
奉仕回数	봉사횟수	1
行動予約	행동예약	1
使役回数	사역횟수	1
取得魔力	취득마력	1
むらむら	불끈불끈	1
B絶回数	B절정횟수	1
C絶回数	C절정횟수	1
前の潤滑	전윤활	1
拘束絶頂	구속절정	1
噴乳経験	분유경험	1
位置上下	위치상하	1
調合知識	약학지식	1
回復早い	회복빠름	1
心根優しい	상냥함	1
自慰経験	자위경험	1
愛撫回数	애무횟수	1
調教回数	조교횟수	1
連続行動	연속행동	1
調教時間	조교시간	1
累積魔力	누적마력	1
触手召喚	촉수소환	1
加虐回数	가학횟수	1
異常経験	이상경험	1
体力管理	체력관리	1
公衆便所	공중변소	1
コスプレ	코스프레	1
道具使い	도구사용	1
奉仕精神	봉사정신	1
愛情経験	애정경험	1
オナホール	오나홀	1
前ACT	전ACT	1
精液経験	정액경험	1
貞操観念	정조관념	1
顔面騎乗	안면승마	1
パイズリ	파이즈리	1
口淫経験	구음경험	1
射精回数	사정횟수	1
仰向け	위로돌리고	1
強制脱衣	강제탈의	1
位置前後	위치전후	1
汚臭敏感	악취민감	1
縛り上手	결박능숙	1
助手方針	조수방침	1
触手経験	촉수경험	1
V絶回数	V절정횟수	1
道具回数	도구횟수	1
四重絶頂	사중절정	1
基本敬称	기본경칭	1
同時絶頂	동시절정	1
調教経験	조교경험	1
乳首舐め	유두핥기	1
習得早い	습득빠름	1
精液中毒	정액중독	1
早漏射精	조루사정	1
調教指令	조교지령	1
拘束中毒	구속중독	1
快楽刻印	쾌락각인	1
自慰中毒	자위중독	1
精力薄弱	정력박약	1
膣内射精	질내사정	1
前回射精	전회사정	1
反抗強度	반항강도	1
空射精	드라이사정	1
奴隷妊娠	노예임신	1
中毒充足	중독충족	1
精力限界	정력한계	1
焦らし	애태움	1
汚れ無視	불결무시	1
方針予約	방침예약	1
一時退避	일시퇴피	1
多重絶頂	다중절정	1
封印日常	봉인일상	1
ターン方針	턴방침	1
露出経験	노출경험	1
口内射精	구강사정	1
習得遅い	습득느림	1
着衣露出	착의노출	1
写真撮影	사진촬영	1
苦痛刻印	고통각인	1
のヒート	히트	0
ご主人様	주인님	1
コピー元	카피원	1
マゾっ気	마조끼	1
ローション	로션	1
情緒豊か	감수성	1
コピー先	카피처	1
助調アク	조조악	1
逆レイプ	역강간	1
抜かず	뽑지않고	1
ヴァギナ	바기나	1
針さばき	바느질	1
レズっ気	레즈끼	1
デバッグ	디버그	1
接触胸	접촉가슴	1
読心能力	독심술	1
男嫌い	남성혐오	1
露出癖	노출증	1
ローマ字	로마자	1
ツンデレ	츤데레	1
満足ボー	만족보	1
腰使い	허리사용	1
胸愛撫	가슴애무	1
足無し	다리없음	1
意地悪	심술쟁이	1
恥じらい	수줍음	1
//射精	사정	1
ACT	ACT	1
接触口	접촉입	1
好奇心	호기심	1
依存度	의존도	1
//理性	이성	1
接触足	접촉발	1
抜け首	머리분리	1
ペニス	페니스	1
生意気	거만함	1
勃起度	발기도	1
楽観的	낙관적	1
//会話	회화	1
//体力	체력	1
バイブ	바이브	1
//愛撫	애무	1
自慰中	자위중	1
消耗度	소모도	1
小柄	작은체형	1
平時ア	평시아	1
利尿剤	이뇨제	1
//満足	만족	1
//技巧	기교	1
献身的	헌신적	1
威圧感	위압감	1
ローター	로터	1
性交中	성교중	1
好感度	호감도	1
//従順	순종	1
正常位	정상위	1
調教中	조교중	1
舌使い	혀사용	1
//羞恥	수치	1
無関心	무관심	1
倒錯的	도착적	1
//欲望	욕망	1
後背位	후배위	1
罪悪感	죄악감	1
反抗的	반항적	1
//気力	기력	1
//使役	사역	1
性行動	성행동	1
騎乗位	기승위	1
//興味	흥미	1
//加虐	가학	1
衝動的	충동적	1
壁抜け	벽통과	1
接触膣	접촉질	1
悲観的	비관적	1
//母乳	모유	1
登場名	등장명	1
//奉仕	봉사	1
猫舌	거친혀	1
//道具	도구	1
性知識	성지식	1
//異常	이상	1
自制的	자제적	1
アナル	애널	1
首輪	목걸이	1
苛立ち	초조	1
//足	다리	1
大鏡	대거울	1
素股	가랑이	1
潮吹き	분수	1
尿意	소변욕	1
サド	새드	1
モード	모드	1
大人しい	얌전함	1
臆病	겁쟁이	1
受け身	수동	1
ビッチ	빗치	1
//胸	가슴	1
//オトコ	남자	1
//濡れた	젖은	1
短気	조급함	1
お仕置き	벌	1
//ランク	랭크	1
//逸脱	일탈	1
//消耗	소모	1
//不潔	불결	1
//抑圧	억압	1
//魔力	마력	1
//年数	연수	1
//反抗	반항	1
//媚薬	미약	1
//射精	사정	1
//性交	성교	1
//虚脱	허탈	1
//放尿	방뇨	1
//靴下	양말	1
//季節	계절	1
//拘束	구속	1
//勃起	발기	1
//達成	달성	1
//待機	대기	1
//早漏	조루	1
//好意	호의	1
//失禁	실금	1
//日常	일상	1
//狂気	광기	1
//母性	모성	1
//不死	불사	1
//貧乳	빈유	1
//情愛	사랑	1
//人魚	인어	1
//威圧	위압	1
//情欲	정욕	1
//素直	순수	1
//魅惑	매혹	1
//遅漏	지루	1
休憩	휴식	1
//合意	합의	1
//噴乳	분유	1
//口	입	1
//手	손	1
//解放	해방	1
美脚	각선미	1
//野外	야외	1
//接触	접촉	1
//屈服	굴복	1
//隷属	예속	1
//恭順	공순	1
//自慰	자위	1
//痛み	아픔	1
//苦痛	고통	1
//幼稚	유치	1
//処女	처녀	1
//屈従	굴종	1
口上	구상	1
昼夜	밤낮	1
//治療	치료	1
//抑鬱	억울	1
//排泄	배설	1
//悦楽	열락	1
//好色	호색	1
//膣精	질정	1
//我慢	인내	1
//脱衣	탈의	1
//気丈	기장	1
//小人	소인	1
//姿勢	자세	1
//慎重	신중	1
//薬品	약품	1
//潤滑	윤활	1
//恋慕	연모	1
//露出	노출	1
//刻印	각인	1
//衣装	의상	1
//妊娠	임신	1
//失神	실신	1
//息子	아들	1
//長身	장신	1
//恥情	치정	1
//罵倒	매도	1
両刀	바이	1
//キス	키스	1
//不快	불쾌	1
//清楚	청초	1
//淫乱	음란	1
//巨乳	거유	1
//恐怖	공포	1
//欲情	욕정	1
//童貞	동정	1
//浣腸	관장	1
//日数	일수	1
//淫乳	음유	1
//淫尻	음고	1
淫壷	음호	1
鞭	채찍	1
針	바늘	1
縄	줄	1

// CSV이나 전각문자 전처리 탈락
//被Ａ挿入者	피Ａ삽입자	1
//快Ａ補正	쾌Ａ보정	1
//快Ｂ補正	쾌Ｂ보정	1
//快Ｃ補正	쾌Ｃ보정	1
//快Ｖ補正	쾌Ｖ보정	1
//Ａ使用中	Ａ사용중	1
//ＢＬっ気	ＢＬ끼	1
//Ｐ使用中	Ｐ사용중	1
//Ｐ挿入中	Ｐ삽입중	1
//Ｖ使用中	Ｖ사용중	1
//Ａ感覚	Ａ감각	1
//Ａ鈍感	Ａ둔감	1
//Ａ敏感	Ａ민감	1
//Ａ絶頂	Ａ절정	1
//Ａ調教	Ａ조교	1
//Ａ拡張	Ａ확장	1
//Ａ経験	Ａ경험	1
//Ｂ感覚	Ｂ감각	1
//Ｂ鈍感	Ｂ둔감	1
//Ｂ敏感	Ｂ민감	1
//Ｂ絶頂	Ｂ절정	1
//Ｂ経験	Ｂ경험	1
//Ｃ感覚	Ｃ감각	1
//Ｃ鈍感	Ｃ둔감	1
//Ｃ敏感	Ｃ민감	1
//Ｃ絶頂	Ｃ절정	1
//Ｃ経験	Ｃ경험	1
//Ｖ感覚	Ｖ감각	1
//Ｖ鈍感	Ｖ둔감	1
//Ｖ敏感	Ｖ민감	1
//Ｖ絶頂	Ｖ절정	1
//Ｖ拡張	Ｖ확장	1
//Ｖ経験	Ｖ경험	1
//快Ａ	쾌Ａ	1
//快Ｂ	쾌Ｂ	1
//快Ｃ	쾌Ｃ	1
//快Ｖ	쾌Ｖ	1

// MAKE_TOOLS.ERB:75
サドマゾ	새드마조	1

// ACT_APPLY_PROCESS.ERB:141
キャンセル補正	취소보정	0

// tflag.csv
性奉	성적봉사	1

// COMABLE.ERB:576
フィストファック	피스트퍽	1

// COMMON_PROCESS_CALC.ERB:1008
// COMMON_GETTER_TRAIN.ERB:348
影響なし	영향없음	0
好印象大	좋은인상	1
好印象小	약간좋은인상	1
悪印象小	나쁜인상	1
悪印象大	약간나쁜인상	1

// FUNCTION_K64.ERB
式中関数	식 안의 함수	1
