// Q: 고유 명사
// V: 유형 명사
// U: 무형 명사
// QAA: 포유류         UFl: 감정             UXt: 온도                  VHn: 인간
// QAB: 조류           UGs: 기체             UXw: 무게                  VIv: 세균
// QAC: 어류           UGu: 법죄             UYa: 맛(미각)              VJw: 보석
// QAD: 파충류,양서류  UHr: 음향,소리 상태   UYh: 인간&동물의 외적 형용 VLq: 액체
// QAE: 곤충류         ULm: 억제(제한)       UYi: 인간&동물의 내적 형용 VLt: 모사(모피)
// QAF: 절지동물       ULw: 법제             UYk: 두께                  VLu: 분비물
// QAG: 연체동물       UMe: 시간             UYl: 길이                  VMa: 소재
// QAH: 원생동물       UMn: 수단(방법, 제도) UYm: 냄새(후각)            VMd: 약품
// QAL: 꽃이름(풀이름) UPp: 상&벌            UYp: 가격고저              VMo: 채권(유가증권)
// QAM: 과일명         UQf: 자격             UYq: 면적(넓이)            VMy: 화폐
// QAN: 나무이름       URc: 지각(인지)       UYr: 비율                  VNn: 국가
// QAO: 농작물명       URt: 권리             UYs: 강도                  VPa: 도료
// QCT: 도시(지명)명   USe: 시각(관망)       UYt: 촉감                  VPe: 도구
// QHP: 병원(분야)명   USm: 사상             VAc: 장신구                VPl: 장소
// QID: 산업(업종)명   USo: 노래             VAm: 동물                  VPt: 식물
// QLG: 언어명         USu: 학문             VBk: 책(도서)              VQm: 남성
// QMM: 화폐명         UTh: 생각(사고)       VBl: 건축물                VQw: 여성
// QMS: 언론기관명     UTi: 질병             VBp: 신체부위              VRw: 놀이기구
// QMU: 음악(곡조)명   UTs: 발화(언어수단)   VCk: 주방기기              VRy: 악기
// QNN: 국가명         UTt: 기술             VCm: 통신기기              VSn: 광물
// QNP: 민족명         UXb: 대소(크기, 규모) VCp: 의복                  VSp: 그림
// QPN: 인명           UXd: 거리             VDt: 세제                  VSs: 우주천문관계
// QWK: 작품명         UXe: 난이도           VEl: 전기기구              VSt: 학습도구
// UAq: 직업(신분)     UXf: 양(다소)         VFd: 음식(음료)            VSw: 집필물(기록물)
// UAr: 예술활동       UXg: 위치고저         VFn: 가구                  VTp: 교통수단
// UCl: 종교행위(수단) UXl: 광도(조명)       VFr: 기상관계              VTw: 무기
// UCr: 색상           UXm: 중요도(상세도)   VGn: 신(성인)
// UDr: 방향           UXs: 속도감           VGt: 집합(군집)

呼び方リスト	호칭목록	0
クリキャップ	클리캡	1	VPe
ボールギャグ	볼개그	1	VPe
ニプルキャップ	니플캡	1	VPe
バイブ	바이브	1	VPe
空射精数	드라이사정수	0
手淫経験	수음 경험	0
一回休み	한번휴식	0

// abl.csv
レズ	레즈	0
レズ中毒	레즈중독	0

// base.csv
尿意	소변욕	0

// exp.csv
口淫経験	구음경험	0

// cflag.csv
コスプレキャンセル補正	코스프레캔슬보정	0
空射回数	드라이사정수	0
通射回数	사정횟수	0
大射回数	대량사정횟수	0
A責射回数	애널사정수	0
口上	구상	1

// item.csv
チャイナ服	차이나드레스	1

// talent.csv
プライド高い	프라이드높음	0
プライド低い	프라이드낮음	0
感情乏しい	감정결핍	0
情緒豊か	감수성	0
一線越えない	선을그음	0
貞操観念	정조관념	0
貞操無頓着	정조관념없음	0
恥薄い	수치심옅음	0
痛みに弱い	아픔에약함	0
痛みに強い	아픔에강함	0
濡れやすい	젖기쉬움	0
濡れにくい	젖기어려움	0
習得早い	습득빠름	0
習得遅い	습득느림	0
針さばき	바느질	0
調合知識	약학지식	0
薬毒耐性	약물내성	0
縛り上手	결박능숙	0
道具使い	도구사용	0
自慰しやすい	자위쉬움	0
汚臭鈍感	악취둔감	0
汚臭敏感	악취민감	0
汚れ無視	불결무시	0
腰使い	허리사용	0
快感に素直	쾌감에순수	0
快感の否定	쾌감을부정	0
淫壷	음란	0
ドＭ	마조	0
男嫌い	남성혐오	0
短気	조급함	0
心根優しい	상냥함	0
親しみやすい	사교적	0
近寄り難い	대인기피	0
小柄	작은체형	0
回復早い	회복빠름	0
回復遅い	회복느림	0
母乳体質	모유체질	0
おもらし癖	소변버릇	0
日光嫌い	햇빛싫어함	0
精力絶倫	정력절륜	0
精力薄弱	정력박약	0
禁断の知識	금단의지식	0
読心能力	독심술	0
壁抜け	벽통과	0
足無し	다리없음	0
撮影技能	촬영기술	0
着衣プレイ好き	착의플레이선호	0

// tcvar.csv, 리버스 EVETRAIN.ERB 공백제거
行動予約	행동예약	0
姿勢	자세	0
前回の姿勢	전회의자세	0
位置前後	위치전후	0
位置上下	위치상하	0
∨挿入対象	∨삽입대상	0
可能なACT系列数	가능한ACT계열수	0
可能なCOM数	가능한COM수	0
加虐回数	가학횟수	0
加虐のヒート	가학의히트	0
刻印2	각인2	0
甘えさせて封印	응석부리게해봉인	0
激しくして封印	격렬하게해봉인	0
苦痛刻印	고통각인	0
苦痛刻印取得	고통각인취득	0
苦痛中毒	고통중독	0
苦痛快楽経験	고통쾌락경험	0
苦痛による理性低下	고통에의한이성저하	0
曲１	곡1	0
曲２	곡2	0
谷渡り	골짜기를건너감	0
空射精	드라이사정	0
公衆肉便器プレイ	공중육변기플레이	0
公衆便所	공중변소	0
恐怖刻印取得	공포각인취득	0
恐怖経験	공포경험	0
狂気の瞳	광기의눈동자	0
口上予約1	구상예약1	0
口上予約10	구상예약10	0
口上予約11	구상예약11	0
口上予約12	구상예약12	0
口上予約13	구상예약13	0
口上予約14	구상예약14	0
口上予約15	구상예약15	0
口上予約16	구상예약16	0
口上予約2	구상예약2	0
口上予約3	구상예약3	0
口上予約4	구상예약4	0
口上予約5	구상예약5	0
口上予約6	구상예약6	0
口上予約7	구상예약7	0
口上予約8	구상예약8	0
口上予約9	구상예약9	0
口上独自実績	구상독자실적	0
口上ACT補正値	구상ACT보정치	0
口上ACT分類補正値	구상ACT분류보정치	0
拘束絶頂	구속절정	0
拘束中毒	구속중독	0
拘束キャンセル補正	구속캔슬보정	0
屈服刻印	굴복각인	0
屈服刻印取得	굴복각인취득	0
屈服経験	굴복경험	0
屈服P1	굴복P1	0
屈服P2	굴복P2	0
口内射精	입안사정	0
口で愛撫	입으로애무	0
口で愛撫を強制	입으로애무를강제	0
今日の方針	오늘의방침	0
今日の満足ボーナス	오늘의만족보너스	0
今回で大満足	이번에대만족	0
今回の勃起	이번발기	0
今の気分を聞く	지금의기분을(듣)묻는다	0
基本敬称	기본경칭	0
緊急ロード	긴급로드	0
緊縛経験	긴박경험	0
騎乗位連続	승마위연속	0
騎乗二穴攻め	승마두구멍공격	0
奴隷妊娠	노예임신	0
奴隷の首輪	노예의목걸이	0
奴隷の首輪封印	노예의목걸이봉인	0
多重絶頂	다중절정	0
大鏡キャンセル補正	대거울캔슬보정	0
大量射精	대량사정	0
大満足ボーナス封印	대만족보너스봉인	0
道具使用経験	도구사용경험	0
道具回数	도구횟수	0
道具のヒート	도구의히트	0
道具を外す	도구를제외한다	0
同時絶頂	동시절정	0
同一行動ボーナス	동일행동보너스	0
童貞喪失	동정상실	0
童貞喪失済み	동정상실이끝난상태	0
頭を踏みつける	머리를짓밟는다	0
連続行動	연속행동	0
鈴蘭の毒	스즈란의독	0
露出経験	노출경험	0
累積魔力	누적마력	0
利尿ヒート	이뇨히트	0
無愛想に応答する	무뚝뚝하게응답한다	0
媚薬等使用	미약등사용	0
媚薬等使用口上	미약등사용구상	0
媚薬等使用地の文スキップ	미약등사용지문스킵	0
反抗刻印	반항각인	0
反抗強度	반항강도	0
反発刻印取得	반발각인취득	0
反発除去	반발제거	0
放尿経験	방뇨경험	0
方針予約	방침예약	0
放置プレイ	방치플레이	0
背面座位連続	배면좌위연속	0
背面座位させる	배면좌위시킨다	0
百合経験	백합경험	0
奉仕騎乗位連続	봉사승마위연속	0
奉仕背面座位連続	봉사배면좌위연속	0
奉仕正常位連続	봉사정상위연속	0
奉仕精神	봉사정신	0
奉仕快楽経験	봉사쾌락경험	0
奉仕回数	봉사횟수	0
奉仕後背位連続	봉사후배위연속	0
奉仕対面座位連続	봉사대면좌위연속	0
奉仕のヒート	봉사의히트	0
封印日常	봉인일상	0
不敵に笑う	겁없게웃는다	0
体力管理	체력관리	0
不気味に笑う	기분나쁘게웃는다	0
悲鳴を上げる	비명을올린다	0
使役回数	사역횟수	0
使役のヒート	사역의히트	0
射精量レコード	사정량레코드	0
射精回数	사정횟수	0
射精後経過ターン	사정후경과턴	0
射精後経過ターン参照	사정후경과턴참조	0
射精経験	사정경험	0
四重絶頂	사중절정	0
三角木馬	삼각목마	0
三角木馬キャンセル補正	삼각목마캔슬보정	0
上半身上着	상반신윗도리	0
上半身下着	상반신속옷	0
選択セット	선택세트	0
性交同時絶頂	성교동시절정	0
性交奉仕中	성교봉사중	0
性交奉仕回数	성교봉사횟수	0
性交回数	성교횟수	0
性交経験	성교경험	0
性交のヒート	성교의히트	0
性器を擦り合う	성기를서로켠다	0
性奉のヒート	성적봉사의히트	0
性知識	성지식	0
性についての話をする	성에대한이야기를한다	0
消極的やる	소극적한다	0
素質表示方法	소질표시방법	0
召喚可能助手	소환가능조수	0
羞恥回数	수치횟수	0
羞恥のヒート	수치의히트	0
羞恥プレイ	수치플레이	0
手で愛撫	손으로애무	0
手で愛撫を強制	손으로애무를강제	0
新聞の記事にする	신문의기사로한다	0
顔面騎乗	안면승마	0
顔面騎乗アナル	안면승마애널	0
押し倒し	밀어넘어뜨리기	0
押し倒し中	밀어넘어뜨리기중	0
押し倒し経過	밀어넘어뜨리기경과	0
押し倒す	밀어넘어뜨린다	0
仰向け	위로돌리고	0
愛撫回数	애무횟수	0
愛撫のヒート	애무의히트	0
愛想よく応答する	붙임성좋게응답한다	0
愛情経験	애정경험	0
愛情を込めてやる	애정을담아준다	0
野外プレイ	야외플레이	0
野外プレイキャンセル補正	야외플레이캔슬보정	0
浣腸セット	관장세트	0
外に出たい封印	밖에나가고싶은봉인	0
腰を振る	허리를흔드는	0
腰をふる	허리를흔든다	0
優先大満足ボーナス	우선대만족보너스	0
優しく慰める	상냥하게위로한다	0
乳首舐め	유두빨고	0
乳首ローター	유두로터	0
衣装の変更を要求する	의상의변경을요구한다	0
二本舐め強制	2개빨고강제	0
異常方針回数	이상방침횟수	0
異常方針のヒート	이상방침의히트	0
異常回数	이상횟수	0
異常経験	이상경험	0
異常のヒート	이상의히트	0
日常能力上昇	일상능력상승	0
日常制御	일상제어	0
一時退避	일시퇴피	0
孕ませたい封印	임신하게하고싶은봉인	0
自分への気持ちを聞く	자신에게로의기분을(듣)묻는다	0
自慰見せつけ	자위과시하고	0
自慰絶頂	자위절정	0
自慰中毒	자위중독	0
自慰経験	자위경험	0
自慰し始める	자위하기시작한다	0
自慰みせつけ	자위과시하고	0
自主脱衣	자주탈의	0
子持ち	아이딸린사람	0
腸内射精後経過ターン	장내사정후경과턴	0
腸内射精後経過ターン参照	장내사정후경과턴참조	0
抵抗不能	저항불능	0
積極奉仕	적극봉사	0
積極的やる	적극적한다	0
前立腺射精	전립선사정	0
前立腺刺激	전립선자극	0
全身上着	전신윗도리	0
前接触Ａ	전접촉A	0
前接触Ｃ	전접촉C	0
前接触Ｐ	전접촉P	0
前調教指令	전조교지령	0
前回射精	전회사정	0
前回助手愛撫箇所	전회조수애무개소	0
前回中出し	전회질내사정	0
前回ターン空射精	전회턴하늘사정	0
前回ターン放尿	전회턴방뇨	0
前回ターン噴乳	전회턴분유	0
前回ターン射精	전회턴사정	0
前回ターン潮吹き	전회턴물총	0
前回ターンＡ絶頂	전회턴A절정	0
前回ターンＢ絶頂	전회턴B절정	0
前回ターンＣ絶頂	전회턴C절정	0
前回ターンＶ絶頂	전회턴V절정	0
前ACT分類	전ACT분류	0
前REACT分類	전REACT분류	0
前ターン方針	전턴방침	0
前ターン性交	전턴성교	0
前ターン性交奉仕	전턴성교봉사	0
前ターン顔面騎乗	전턴안면승마	0
前ターンＡ顔面騎乗	전턴A안면승마	0
前の勃起度	전의발기도	0
前の潤滑	전의윤활	0
絶頂経験	절정경험	0
接触Ａ	접촉A	0
接触Ｃ	접촉C	0
接触Ｐ	접촉P	0
精力限界	정력한계	0
正常位連続	정상위연속	0
正常位させる	정상위시킨다	0
精液中毒	정액중독	0
精液経験	정액경험	0
早漏射精	조루사정	0
早漏回数	조루횟수	0
助手１行動予約	조수1행동예약	0
助手２行動予約	조수2행동예약	0
助手連続交合	조수연속교합	0
助手方針	조수방침	0
助手性交奉仕中	조수성교봉사중	0
助手性交中	조수성교중	0
助手前ACT	조수전ACT	0
助手ACT	조수ACT	0
助手ACT派生	조수ACT파생	0
助手SPACT	조수SPACT	0
助手イベント番号	조수이벤트번호	0
助手が挿入中	조수가삽입중	0
助手に挿入中	조수에삽입중	0
助手の方針	조수의방침	0
助手の前行動	조수의전행동	0
潮吹き経験	물총경험	0
助行パタ	조행파타	0
足使用中	다리사용중	0
足舐め強制	다리빨고강제	0
足コキする	풋잡한다	0
足を舐めさせる	다리를빨게한다	0
調教時間	조교시간	0
調教者連続実行回数	조교자연속실행횟수	0
調教者消耗度	조교자소모도	0
調教自慰経験	조교자위경험	0
調教者行動予約	조교자행동예약	0
調教者行動済	조교자행동제	0
調教者とキス	조교자와키스	0
調教者ペニスバンド	조교자페니스밴드	0
調教指令	조교지령	0
調教回数	조교횟수	0
調教内童貞喪失	조교내동정상실	0
調教内処女喪失	조교내처녀상실	0
調教対象AI	조교대상AI	0
調教対象Ｃ使用	조교대상C사용	0
調教UIパッド表示モード	조교UI패드표시모드	0
調教UIパッド化	조교UI패드화	0
調教レベル	조교레벨	0
中毒充足	중독충족	0
膣内射精	질내사정	0
膣内射精後経過ターン	질내사정후경과턴	0
膣内射精後経過ターン参照	질내사정후경과턴참조	0
指挿入	손가락삽입	0
指挿入れ	손가락삽입해라	0
地の文制御	지문제어	0
地の文スキップ	지문스킵	0
着衣露出	착의노출	0
焦らし度	초조하게해번	0
焦らしプレイ	초조하게해플레이	0
最短調教時間記録	최단조교시간기록	0
最長調教時間記録	최장조교시간기록	0
追加調教者数	추가조교자수	0
追加行動	추가행동	0
追加行動口上	추가행동구상	0
追加行動地の文スキップ	추가행동지문스킵	0
追加ACT	추가ACT	0
取得魔力	취득마력	0
治療ヒート	치료히트	0
恥辱快楽経験	치욕쾌락경험	0
痴態を見つめる	치태를응시한다	0
快感を受け入れる	쾌감을받아들인다	0
快感を我慢する	쾌감을참는다	0
快楽刻印	쾌락각인	0
快楽刻印取得	쾌락각인취득	0
快楽による理性低下	쾌락에의한이성저하	0
痛みを我慢する	아픔을참는다	0
平然とやる	태연하게한다	0
抱いてほしい封印	안아주었으면하는봉인	0
被口内射精	피입안사정	0
被膣射Ｖ絶頂	피질쏘아맞히고V절정	0
被膣内射精	피질내사정	0
被肛内射精	피항내사정	0
必要経験値	필요경험치	0
下半身上着	하반신윗도리	0
下半身下着	하반신속옷	0
下手だと罵る	서투르다고매도한다	0
合意を求める	합의를요구한다	0
肛内射精	항내사정	0
行動助手番号	행동조수번호	0
許しを乞う	허가를청한다	0
好感度アップ	호감도업	0
好意的反応	호의적반응	0
後背位連続	후배위연속	0
後背位させる	후배위시킨다	0
休憩方針回数	휴게방침횟수	0
休憩方針のヒート	휴게방침의히트	0
休憩回数	휴게횟수	0
胸使用中	가슴사용중	0
胸愛撫	가슴애무	0
胸愛撫強制	가슴애무강제	0
休ませて封印	쉬게해봉인	0
休ませる	쉬게한다	0
両穴フィスト	양구멍피스트	0
会話回数	회화횟수	0
会話経験	회화경험	0
会話のヒート	회화의히트	0
写真撮影	사진촬영	0
処女喪失	처녀상실	0
処女喪失済み	처녀상실이끝난상태	0
厳しく脅す	엄격하게위협한다	0
壊れるまでして封印	망가질때까지해봉인	0
変則乱れ牡丹	변칙혼란모란	0
実行COM名	실행COM명	0
対面二穴攻め	대면두구멍공격	0
対面座位連続	대면좌위연속	0
対面座位させる	대면좌위시킨다	0
対象拒否回数	대상거부횟수	0
対象無影響回数	대상무영향횟수	0
対象消極従回数	대상소극종횟수	0
対象哀願回数	대상애원횟수	0
対象積極従回数	대상적극종횟수	0
対象暴れ回数	대상날뛰고횟수	0
強制脱衣	강제탈의	0
強気に応答する	강하게응답한다	0
抜かず	뽑지않고	0
抜かずの三発	뽑지않고의세발	0
抜かずの二発	뽑지않고의2발	0
拠点キャラ数	거점캐릭터수	0
既出の話題	기출의화제	0
栄養剤を飲ませる	영양제를먹인다	0
栄養ヒート	영양히트	0
気力管理	기력관리	0
気持ち良くして	기분좋게해	0
満足ボー	만족보	0
満足ボーナス	만족보너스	0
状態変化	상태변화	0
状態変化持続	상태변화지속	0
経験値アップ	경험치업	0
触手使役術	촉수사역방법	0
触手射精	촉수사정	0
触手召喚	촉수소환	0
触手調教中	촉수조교중	0
触手経験	촉수경험	0
A調教目的	A조교목적	0
Ａ拡張経験	A확장경험	0
Ａ挿入対象	A삽입대상	0
ACT分類	ACT분류	0
ACT分類予約	ACT분류예약	0
ACT小派生	ACT소수파생	0
ACT派生	ACT파생	0
Ｃ愛撫道具	C애무도구	0
Cha総数	Cha총수	0
COM表示法	COM표시법	0
COMABLE抑制用	COMABLE억제용	0
END達成	END달성	0
M調教目的	M조교목적	0
PALAMアニメ	PALAM애니메이션	0
REACT負荷	REACT부하	0
REACT分類	REACT분류	0
REACT印象	REACT인상	0
REACT姿勢変化	REACT자세변화	0
REACT派生	REACT파생	0
T調教目的	T조교목적	0
TXT頻度	TXT빈도	0
Ｖ拡張経験	V확장경험	0
アナル愛撫	애널애무	0
アナル二穴攻め	애널두구멍공격	0
アナル舐め	애널빨고	0
アナルセックス	애널섹스	0
アナルセックスさせる	애널섹스시킨다	0
アナルバイブ	애널바이브	0
アナルビーズ	애널비즈	0
アナルフィスト	애널피스트	0
アナルローター	애널로터	0
アナルをいじめて封印	애널을괴롭혀봉인	0
アニメ効果コンフィグ	애니메이션효과콘피그	0
アライメント変動	아라이먼트변동	0
アライメント変動傾向	아라이먼트변동경향	0
イかせ経験	가게한경험	0
イかせた	가게했다	0
イかせて	가게해	0
イかせて！	가게해!	0
イかせて挙動制御用	가게해거동제어용	0
イきそう	갈것같다	0
いつも通り封印	언제나대로봉인	0
イベント番号	이벤트번호	0
オートモード	오토모드	0
オートモード登録0	오토모드등록0	0
オートモード登録1	오토모드등록1	0
オートモード登録2	오토모드등록2	0
オートモード登録3	오토모드등록3	0
オートモード登録4	오토모드등록4	0
オートモード表示設定	오토모드표시설정	0
お仕置きして封印	벌해봉인	0
お仕置きと宣言する	벌이라고선언한다	0
カスタム道具	커스텀도구	0
かわいがり封印	귀여워해봉인	0
キス経験	키스경험	0
ご奉仕したい封印	봉사하고싶은봉인	0
コンビネーション予約	콤비네이션예약	0
ソフト方針のヒート	소프트방침의히트	0
ソフト回数	소프트횟수	0
ターン方針	턴방침	0
ダイアログ用一時使用	다이얼로그용일시사용	0
デバッグ表示オフ	디버그표시오프	0
なすがまま	하는대로	0
ノーマル方針のヒート	노멀방침의히트	0
ノーマル回数	노멀횟수	0
ハード方針のヒート	하드방침의히트	0
ハード回数	하드횟수	0
パイズリする	파이즈리한다	0
パラメーター変動	파라미터변동	0
フィストファック	피스트퍽	0
プレイ時間	플레이시간	0
ペニスバンド	페니스밴드	0
ペニスバンド装着	페니스밴드장착	0
もっとハードにして	좀더하드하게해	0

// ACT_APPLY_PROCESS.ERB:141
キャンセル補正	캔슬보정	0

// tflag.csv
性奉	성적봉사	1

// COMABLE.ERB:576
フィストファック	피스트퍽	1

// COMMON_PROCESS_CALC.ERB:1008
// COMMON_GETTER_TRAIN.ERB:348
影響なし	영향없음	0
好印象大	좋은인상	1
好印象小	약간좋은인상	1
悪印象小	나쁜인상	1
悪印象大	약간나쁜인상	1

// FUNCTION_K64.ERB
式中関数	식 안의 함수	1
